[[
1 1 1 1 1 1 1 1 1 1 1 1 1 1 1 1 1 1 1 1 1 1 1 1 1 1 1 1 1 1 1 1 1 1 1 1 1 1 1 1 1 1 1 1 1 1 1 1
1                                                                                             1
1                                                                                             1
1       1 1 1                                                                                 1
1           1                                                                                 1
1 1 1                                                                                         1
1           1                                                                                 1
1         1 1                                                                                 1
1           1                                                                                 1
1 1 1       1                                                                                 1
1           1                                                                                 1
1           1                                                                                 1
1       1 1 1                                                                                 1
1                                                                                             1
1           1                                                                                 1
1 1 1       1                                                                                 1
1                                                                                             1
1                                                                                             1
1       1 1 1                                                                                 1
1           1                                                                                 1
1 1 1                                                                                         1
1           1                                                                                 1
1                                                                                             1
1       1 1 1                             1                                                   1
1                                                                                             1
1                                                                                             1
1 1 1       1                             y                                                   1
1                                                                                             1
1       1 1               1       o       1                                                   1
1                         1               1                                                   1
1 1 1                 f   1 1 1 1 1 1 1 1 1 1 1 1 1 1 1 1 1 1 1 1                             1
1 1 1 1 1 1 1 1 1 1 1 1 1 1 1 1 1 1 1 1 1 1 1 1 1 1 1 1 1 1 1 1 1 1 1 1 1 1 1 1 1 1 1 1 1 1 1 1
]]